11111
1E0C1
11C11
11CC1
1C1P1
11111
