111111111111111111111111111111111111111
1EPC00000000000000000000000000000000001
1C1C00000000000000000000000000000000001
1C1C00000000000000000000000000000000001
1C1000000000000000000000000000000000001
100000010000000000000000000000000000001
100000000000000000000000000000000000001
100000000000000000000000000000000000001
100000000000000000000000000000000000001
100000000000000000000000000000000000001
100000000000000000000000000000000000001
100000000000000000000000000000000000001
100000000000000000000000000000000000001
111111111111111111111111111111111111111
