11111
1E001
1P011
1CCC1
10111
11111
