11111
1E0C1
1C1C1
1C1C1
1C1P1
11111
