111111111111111111111111111111111111111
1E0C00000000000000000000000000000000001
1C1C00000000000000000000000000000000001
1C1C00000000000000000000000000000000001
1C1P00000000000000000000000000000000001
100000010000000000000000000000000000001
100000000000000000000000000000000000001
100000000000000000000000000000000000001
100000000000000000000000000000000000001
100000000000000000000000000000000000001
100000000000000000000000000000000000001
100000000000000000000000000000000000001
100000000000000000000000000000000000001
111111111111111111111111111111111111111
