111111111111
1E0C00000001
1C1C00000001
1C1C00000001
1C1P00000001
111111111111
